##########
#........#
#........#
#........#
#...S....#
#........#
#........#
#........#
#........#
##########